40  16  29  28  27  29  27  28  27  29  28  27  29  17  40   0 
40  22  55  56  55  55  55  56  55  56  56  55  55  25  40   0 
40  14  19  20  19  20  18  19  18  20  18  20  19  15  40   0 
16  27  29  28  27  34  52  33  28  29  28  17  41  40  40   0 
23   1   1  13   1   1   1   1   1   1   1  33  27  28  17   0 
21   2  35  18  19  36   1  35  18  36   1   1   1   1  26   0 
34   3  33  31  17  38   1  33  31  34   1  35  36   1  33   0 
54   8  13   7  26  22   1   1   1   1   1  25  22   1  53   0 
18  19  36   8  24  14  36   1  35  20  18  15  21   1  35   0 
40  39  22   1  33  30  34   1  33  32  31  30  34   1  24   0 
40  16  34   1   1   1   1   1   1   1   1   1   1   1  26   0 
40  23   1   1  35  36   1  35  18  19  20  36   1  35  15   0 
40  21   1  35  15  21   1  33  28  29  17  22   1  24  40   0 
40  23   1  33  17  22   1   1   1   1  24  23   1  26  40   0 
40  22   1   1  33  34   1  35  36   1  33  34   1  25  40   0 
40  14  36   1   1   1   5  37  38   1   1   1   1  24  40   0 
40  40  14  20  19  36  51  25  14  20  18  20  19  15  40   0