40  16  29  28  27  29  27  28  27  29  28  27  29  17  40   0
40  22  55  56  55  55  55  56  55  56  56  55  55  25  40   0
40  14  19  20  19  20  18  19  18  20  18  20  19  15  40   0
16  27  29  28  27  27  17  23  52  33  28  34  52  24  40   0
23   1   1   1   1   1  33  34   1   1   1   1   1  26  41   0
21   1  35  18  36   1   1   1   1  35  19  36   1  24  40   0
34   1  33  31  34   1  35  36   1  25  16  34   1  33  27   0
54   1   1   1   1   1  25  21   1  33  34   1   1   1  53   0
18  19  20  18  36   1  24  22   1   1   1   1  35  20  19   0
41  40  40  40  23   1  26  14  20  18  36   1  24  39  40   0
16  27  28  27  34   1  25  39  16  29  34   1  33  17  40   0
23   1   1   1   1   1  24  40  23   1   1   1   1  25  40   0
22   1  67  69   1  35  15  41  22   1  35  36   1  24  40   0
22   1  64  66   1  33  31  32  34   1  24  23   1  26  41   0
23   1  61  63   1   1   1   1   1   1  24  22   1  25  40   0
22   1   1   1   1  35  19  36   1  35  15  21   1  26  40   0
14  18  19  20  19  15  40  23  51  25  40  23  51  24  40   0